You've been walking for what seems like hours... or maybe days...or who knows, it could have just been minutes.  You only remember as far back as walking along this corridor.  Nothing else has existed in your mind prior to the corridor and you can only think of moving forward.  As you peer over your shoulder there is nothing to see.  The darkness seems to encroach your location at every step, yet the way ahead is lit by some unseen light.   The corridor is your existence.....

Lizards
An Interactive Fiction by Jason Lautzenheiser
Release 1 / Serial number 140511 / Inform 7 build 6L02 (I6/v6.33 lib 6/12N) SD

The Corridor
An ancient corridor overgrown with brush and vines.  Dimly lit, you can see to the north the dim outline of an exit that you thought would never come.   Back to the south, the corridor fades into darkness.

>n
The Entrance
You are standing at the entrance of the corridor.  You've been the corridor for what seems like a lifetime and the light is blinding.  You can only make out dim shapes.

>showme player
There seems to be no such object anywhere in the model world.

>showme me
yourself - person
location: in the The Entrance
singular-named, proper-named; unlit, inedible, portable; male, blinded
printed name: "yourself"
printed plural name: "people"
indefinite article: none
description: "As good-looking as ever."
initial appearance: none
carrying capacity: 100

>l
The Entrance
You are standing at the entrance of the corridor.  You've been the corridor for what seems like a lifetime and the light is blinding.  You can only make out dim shapes.

* * *

>n
The Entrance
You are standing at the entrance of the corridor.  You've been the corridor for what seems like a lifetime and the light is blinding.  You can only make out dim shapes.

>l
The Entrance
You are standing at the entrance of the corridor.  You've been the corridor for what seems like a lifetime and the light is blinding.  You can only make out dim shapes.

>l
The Entrance
You are standing at the entrance of the corridor.  You've been the corridor for what seems like a lifetime and the light is blinding.  You can only make out dim shapes.

>z
Time passes.

>z
Time passes.

Your eyes slowly adjust to the light and you can better make out your surroundings now.

>l
The Entrance
You are standing at the entrance of the corridor.  Looking out the entrance you see a path leading into a small village. You notice a man dressed in the armor of a knight leaning on corridor wall.  He blends in so well with the wall, he is hard to see.

>x knight
You see nothing special about the knight.

>x rutherford
You see nothing special about the knight.

* * *

>n
The Entrance
You are standing at the entrance of the corridor.  You've been the corridor for what seems like a lifetime and the light is blinding.  You can only make out dim shapes.

>s
You can barely see, you best not move until your eyes adjust.

>n
You can barely see, you best not move until your eyes adjust.

>l
The Entrance
You are standing at the entrance of the corridor.  You've been the corridor for what seems like a lifetime and the light is blinding.  You can only make out dim shapes.

* * *

>n
You can barely see, you best not move until your eyes adjust.

>n
You can barely see, you best not move until your eyes adjust.

>s
You can barely see, you best not move until your eyes adjust.

>s
You can barely see, you best not move until your eyes adjust.

>sz
That's not a verb I recognise.

>z
Time passes.

>z
Time passes.

I beg your pardon?

I beg your pardon?

>showme me
yourself - person
location: in the The Entrance
singular-named, proper-named; unlit, inedible, portable; male, blinded
printed name: "yourself"
printed plural name: "people"
indefinite article: none
description: "As good-looking as ever."
initial appearance: none
carrying capacity: 100

* * *

>n
The Entrance
You are standing at the entrance of the corridor.  You've been the corridor for what seems like a lifetime and the light is blinding.  You can only make out dim shapes.

>z
Time passes.

>z
Time passes.

Your eyes slowly adjust to the light and you can better make out your surroundings now.

As your eyes adjust to the light, you notice movement along the wall just inside the entrance.  You see a man in armor leaning against the wall.

>z
Time passes.

"I'm on my way to see the king."

>z
Time passes.

"You can follow along if you'd like."

the knight goes north.

>showme me
yourself - person
location: in the The Entrance
singular-named, proper-named; unlit, inedible, portable; male, blinded
printed name: "yourself"
printed plural name: "people"
indefinite article: none
description: "As good-looking as ever."
initial appearance: none
carrying capacity: 100

* * *

>z
Time passes.

"You can follow along if you'd like."

the knight goes north.

>z
Time passes.

>l
The Entrance
You are standing at the entrance of the corridor.  You've been the corridor for what seems like a lifetime and the light is blinding.  You can only make out dim shapes.

>n
You can barely see, you best not move until your eyes adjust.

* * *

>z
Time passes.

"You can follow along if you'd like."

the knight goes north.

>l
The Entrance
You are standing at the entrance of the corridor.  Looking out the entrance you see a path leading into a small village.

>n
pathway
You are standing on the cobblestone pathway to the small village of Prussia which lies to your east.

You can see the knight here.

* * *

>z
Time passes.

Your eyes slowly adjust to the light and you can better make out your surroundings now.

As your eyes adjust to the light, you notice movement along the wall just inside the entrance.  You see a man in armor leaning against the wall.

>k
That's not a verb I recognise.

>l
The Entrance
You are standing at the entrance of the corridor.  Looking out the entrance you see a path leading into a small village. You notice a man dressed in the armor of a knight leaning on corridor wall.  He blends in so well with the wall, he is hard to see.

You can see a knightRutherford the Brave here.

* * *

>z
Time passes.

Your eyes slowly adjust to the light and you can better make out your surroundings now.

As your eyes adjust to the light, you notice movement along the wall just inside the entrance.  You see a man in armor leaning against the wall.

>l
The Entrance
You are standing at the entrance of the corridor.  Looking out the entrance you see a path leading into a small village. You notice a man dressed in the armor of a knight leaning on corridor wall.  He blends in so well with the wall, he is hard to see.

You can see a knightRutherford the Brave here.

>l
The Entrance
You are standing at the entrance of the corridor.  Looking out the entrance you see a path leading into a small village. You notice a man dressed in the armor of a knight leaning on corridor wall.  He blends in so well with the wall, he is hard to see.

You can see a knightRutherford the Brave here.

* * *

>z
Time passes.

Your eyes slowly adjust to the light and you can better make out your surroundings now.

As your eyes adjust to the light, you notice movement along the wall just inside the entrance.  You see a man in armor leaning against the wall.

>n
The knight is blocking your way.

"I'm on my way to see the king."

>m
That's not a verb I recognise.

>n
The knight is blocking your way.

"You can follow along if you'd like."

>n
The knight is blocking your way.

the knight goes north.

>n
pathway
You are standing on the cobblestone pathway to the small village of Prussia which lies to your east.

You can see the knight here.

>s
The Entrance
You are standing at the entrance of the corridor.  Looking out the entrance you see a path leading into a small village.

>n
pathway
You are standing on the cobblestone pathway to the small village of Prussia which lies to your east.

You can see the knight here.

>e
the knight goes east.

Streets of Prussia
You are walking along the streets of Prussia, a small medieval village.

You can see the knight here.

* * *

>z
Time passes.

>l
The Entrance
You are standing at the entrance of the corridor.

>n
You can't go that way.

>s
The Corridor
An ancient corridor overgrown with brush and vines.  Dimly lit, you can see to the north the dim outline of an exit that you thought would never come.   Back to the south, the corridor fades into darkness.

>n
The Entrance
You are standing at the entrance of the corridor.

>l
The Entrance
You are standing at the entrance of the corridor.

* * *

I beg your pardon?

>z
Time passes.

* * *

>z
Time passes.

Your eyes slowly adjust to the light and you can better make out your surroundings now.

As your eyes adjust to the light, you notice movement along the wall just inside the entrance.  You see a man in armor leaning against the wall.

>x man
You see nothing special about the knight.

The chorus now begins its entry, accompanying with anapestic song its march up the eisodos.

>n
The knight is blocking your way.

The chorus draws nearer, stomping and clomping and swinging their baskets of cheese.

>s
The way back is no more, your only choice is forward.

You stand aside as the chorus fills the orchestra and dances to and fro.

>s
The way back is no more, your only choice is forward.

The tune of the aulos-player grows more and more frenzied and then breaks off.

>s
The way back is no more, your only choice is forward.

* * *

>n
The Entrance
You are standing at the entrance of the corridor.  You've been the corridor for what seems like a lifetime and the light is blinding.  You can only make out dim shapes.

>n
You can barely see, you best not move until your eyes adjust.

>z
Time passes.

* * *

>z
Time passes.

Your eyes slowly adjust to the light and you can better make out your surroundings now.

>z
Time passes.

>l
The Entrance
You are standing at the entrance of the corridor.  Looking out the entrance you see a path leading into a small village. You notice a man dressed in the armor of a knight leaning on corridor wall.  He blends in so well with the wall, he is hard to see.

You can see Rutherford the Brave here.

* * *

>z
Time passes.

Your eyes slowly adjust to the light and you can better make out your surroundings now.

>n
pathway
You are standing on the cobblestone pathway to the small village of Prussia which lies to your east.

>n
You can't go that way.

>e
Streets of Prussia
You are walking along the streets of Prussia, a small medieval village.

* * *

>n
You can barely see, you best not move until your eyes adjust.

I beg your pardon?

>z
Time passes.

Your eyes slowly adjust to the light and you can better make out your surroundings now.

As your eyes adjust to the light, you notice movement along the wall just inside the entrance.  You see a man in armor leaning against the wall.

>l
The Entrance
You are standing at the entrance of the corridor.  Looking out the entrance you see a path leading into a small village. You notice a man dressed in the armor of a knight leaning on corridor wall.  He blends in so well with the wall, he is hard to see.

You can see the knight here.

"I'm on my way to see the king."

>l
The Entrance
You are standing at the entrance of the corridor.  Looking out the entrance you see a path leading into a small village. You notice a man dressed in the armor of a knight leaning on corridor wall.  He blends in so well with the wall, he is hard to see.

You can see the knight here.

"You can follow along if you'd like."

>l
The Entrance
You are standing at the entrance of the corridor.  Looking out the entrance you see a path leading into a small village. You notice a man dressed in the armor of a knight leaning on corridor wall.  He blends in so well with the wall, he is hard to see.

You can see the knight here.

the knight goes north.

>n
pathway
You are standing on the cobblestone pathway to the small village of Prussia which lies to your east.

You can see the knight here.

>x knight
You see nothing special about the knight.

>e
the knight goes east.

Streets of Prussia
You are walking along the streets of Prussia, a small medieval village.

You can see the knight here.

You follow the knight into the streets of Prussia.  The cobblestone streets are empty of any others, though you notice a few shutters on nearby shops closing quickly as the two of you enter the village.

You see a young child peeking around a nearby house to the south.

>x n
You see nothing unexpected in that direction.

A large bug runs along the cobblestone and crosses in front of the knight.  Without looking down he moves to crush it as it scurries underneath his boot heel.

>n
As you begin to move past the knight, despite being lost in thought, he moves blocking your path.

The knight peers around from side to side as if looking for something.

>s
As you begin to move past the knight, despite being lost in thought, he moves blocking your path.

"There is a place we should go, " and he quickly moves between two houses to the north and into the forest beyond.

You feel like you have no other choice but to follow the knight into the dark woods.

You can't go that way.

>l
Streets of Prussia
You are walking along the streets of Prussia, a small medieval village.

You can see the knight here.

* * *

>n
The Entrance
You are standing at the entrance of the corridor.  You've been the corridor for what seems like a lifetime and the light is blinding.  You can only make out dim shapes.

>scenes
Scene 'Entire Game' playing (for 1 mins now)
Scene 'Meeting Rutherford' playing (for 1 mins now)
(Scene monitoring now switched on. Type "scenes off" to switch it off again.)

* * *

>s
The way back is no more, your only choice is forward.

>n
The Entrance
You are standing at the entrance of the corridor.  You've been the corridor for what seems like a lifetime and the light is blinding.  You can only make out dim shapes.

>s
The way back is no more, your only choice is forward.

>e
You can barely see, you best not move until your eyes adjust.

* * *

>e
You can't move through the walls.

>w
You can't move through the walls.